##########
#P     # #
# ### #E##
#   #    #
### ######
#        #
##########